11111111111111111111111111111111111
16333333333333333333333333333333361
13333333333333333333333333333323231
13333333335555533335555555553323271
13333333333313333333333333333323231
13333333333333113133333333333323231
13333333333333111113333333333323231
13333333333333333333331113333323231
13333333333233333333333333333323231
13333333333332222223333333333323271
13333333333333333332223333333323231
13333333333333333333332222233323231
13333333333333333333333333333323331
13333333333333333333333333333333331
13333333333333333333333333333333331
13333333333333833333333333333333331
13333333333333333333333333333333331
13336333333333333333333334333333331
11111111111111111111111111111111111