11111111111111111111111111111111111
10000000600000000000000000000000001
10000000334444433334444444444024201
10000000005555500005555555550020271
10000000000010000000000000000020201
10000000000000110100000000000020201
10004300000000111110000003330020201
10004300000000000000001113330020201
10004300000200000000000003330020201
10004300000002222220000003330020271
10004300000000000002220000000020201
10004300003330000000002222200020201
10004300000000000000000000000020001
10000300000000000000333333333333331
10000300000333333330000000000000001
10000000000333833330000000000000001
10000000000333333330000000000000001
10000000000000000000000000000000001
11111111111111111111111111111111111