11111111111111111111111111111111111
10000000600000000000000000000000001
10000000334444433334444444444024201
10000000005555500005555555550020271
10000000000010000000000000000020201
10000000000000110100000000000020201
10000000000001111100000003330020201
10000000000000006006001113330020201
10022232222000000000000603330020201
10000000000022222200000003330020271
10000003000000000022260000000020201
16000000333300000000022222200020201
16000000000000000000000000000020001
16000707000000000063333333333333331
10000000000000000000000000000000001
10000000000008000000000000000000001
10000000000000000000000000000000001
10000000000000000000000000000000001
11111111111111111111111111111111111