11111111111111111111111111111111111
16333333333333333333333333333333361
13333333333333333333333333333323231
13333333335555533335555555553323271
13333333333313333333333333833323231
13333333333333113133333333033323231
13333333333333111113333333033323231
13333333333333333333331113033323231
13333333333233333333333333033323231
13333333333332222223333333033323271
13333333333333333332223333033323201
13333333333333333333332222033323201
13333333333333333333333333000000001
13333333333333333333333333333333331
13333333333333333333333333333333341
13333333333333033330333333333333301
13333333333333333333333333333333371
13336333333333333333333334333333391
11111111111111111111111111111111111