11111111111111111111111111111111111
14333433313333333313333333333333361
10333333313333333313333333333333231
10333333314545534315555555553333271
13333333313333333313333333333333231
10333333513333433313333333033333231
10333333313333333313333333033333231
10333334313333333343334443033333231
16333332213338333313333333333333331
10333333313333333313333333033333271
10333333443333333313333333033333201
10333333343333333313373333033333201
13333333313333333313333333327333301
13333333315533333434333333333333331
13333333313333333434333333333333301
13333333313333333434333333333333301
13333333313339333434333333333333371
13336333313333333434333334333333301
11111111111111111111111111111111111