~CNT_WIN_DIAMOND=7
~PRESSURE_NON_CRITICAL=500
~
11111111111111111111111111111111111
14333433333333333333333333333333361
10333333333333338333333333333333231
10333333334545534335555555553333271
12222222222222222222222222222333231
10333333533333433333333333033333231
10333333353333333333333333033333231
10333334333333333333334443033333231
16333332222222222223322222222222231
10333333333333333333333333033333271
10333333443333333332223333033333201
1033AA33343333333333332222033333201
12222222222222222222222222227333301
13333333335533333433333333333333331
13333333333333333433333333333333301
13333333333333333433333333333333301
13333333333333333433333333333333371
19336333333333333433333334333333301
11111111111111111111111111111111111